R 1920 1080
WE texture/pierre.xpm
NO texture/nord.xpm
SO texture/murs.xpm
EA texture/briqueclair.xpm
F 0,100,14
C 45,87,200

S texture/ct1.xpm 
1111111111
1000020001
1020202001
1200000001
1000002001
1000000001
10000N0001
1111111111
