R 1300 800
NO texture/nord.xpm
SO texture/murs.xpm
WE texture/pierre.xpm
EA texture/briqueclair.xpm

S texture/ct1.xpm
F 150,143,120
C 207,231,232

11111111111111111111111111111111111
11111111111111111110000100000002001
11111111111111111111000000000010001
11111111111111111110000000000000001
11111111111111111110001111111000001
10020000000011110000001000011100001
11100000201000000000000000000000001
10000010001020000000000000000000021
12000000001000000001011101111000011
11000000001000011111011111111000001
10000000000000100000011111111000001
12000000001000100011111111111020001
11010001101000100010001000000000001
11211000011101101110000000000200001
11211111111000101111011000200000011
11211112002001101110001000000000001
11011110111000001110001000001100101
10000100110200001110001200000100001
10200020112000001111011000000000111
11101111100000000000011111111111111
11101111102000020000011111111111111
10000011111101111000011111111111111
10000211111101111020011111111111111
10000011111101111000011111111111111
10002011111101111000011111111111111
10002011111101111002011111111111111
10200011111101111000011111111111111
10020011111101111000211111111111111
10002000000000000000011111111111111
100002000000N0020000011111111111111
10000000000000000000011111111111111
11111111111111111111111111111111111